width: 40
height: 15
---
xxxxxxxxxxxxxxxxxxxxxxxxxxxxxxxxxxxxxxxx
x  *               S     x             x
x            O            x    *   *   x
x                      * x             x
x         s        xxxxxxx            sx
x     xxx *   xx                       x
x                            xxx       x
x            xxxxxxxxxx        x       x
x         *                    x   *   x
x      S              S     *  x       x
x  *            *                      x
x        O                             x
x     xx     s        xs               x
x  P      *           x       *        x
xxxxxxxxxxxxxxxxxxxxxxxxxxxxxxxxxxxxxxxx
---
