width: 40
height: 15
---
xxxxxxxxxxxxxxxxxxxxxxxxxxxxxxxxxxxxxxxx
x  *               S     x             x
x            O            x    *   *   x
x     v                * x             x
x         s        xxxxxxx     v      sx
x     xxx *   xx       v               x
x                            xxx       x
x    v       xxxxxxxxxx        x       x
x         *     v              x   *   x
x      S              S     *  x       x
x  *            *            v         x
x       vO                             x
x     xx     s   v    xs           v   x
x  P      *           x       *        x
xxxxxxxxxxxxxxxxxxxxxxxxxxxxxxxxxxxxxxxx
---
